Monaden Hall

1111111111113110
3222222222222230
1222222222122210
1111111111122220
0000000000122210
0000000000122610
0000000000722610
0000000000722410
0000000000222410
0000000000722510
0000000000222510
0000000000122510
0000000000122410
0000000000122410
0000000000131110

0 = nothing
1 = walls
2 = ground
3 = doors
4 = lockers
5 = black lockers
6 = trash
7 = black board