Outside Monaden

1131111111111121
1222222222222222
1222222111661111
1222222222222222
1222222222222222
1222222221661111
1222111111222300
1222454444222100
1222444454222100
1222454444222100
1222444454222111
1222454444222222
1222444444222222
1222222222222111
1212222222222100
1311111111111100

0 = nothing
1 = walls
2 = grey-ground
3 = door
4 = sand
5 = tree
6 = stars