Small room in Monaden

1111666111111100
1322222222222100
1322225555222100
1445254444522111
1445254444525441
1445254444525441
1445254444525441
1222225555222221
1222222222222222
1222222222222221
1111166666111111
0000000000000000
0000000000000000
0000000000000000

0 = nothing
1 = walls
2 = ground
3 = bookshelf
4 = table
5 = chairs
6 = whiteboard